1111111111111111111111111111111
1CP001100000000000000001C1000C1
1C1C0000000000000000000101000C1
10100000000000000000000101C0001
1C1C0000000000000000000101000C1
1C1C0110000000S00000000000000C1
10100000100000000000000000C0001
1C1C0000000000000000000000000C1
1C1C0110000000000000000000000C1
1C1C0110000000000000000000000C1
1C1C0110000000000000000000000C1
1C1C0110000000000000000000000C1
1C1C0110000000000011100000000C1
1C1C0110000000000010100000000C1
1C1C011000000000001E100000000C1
1C1C0110000000000010100000000C1
1C1C0110000000000010000000000C1
1010000010000000001C10000000C01
1111111111111111111111111111111