11111111111111111111111111
1P000000000000000000000001
10111111110111111111111101
100000000S0000S00000000001
1011111S111011111111111101
100000000SC00000000000S001
1011111111SSS11111111111C1
1000000000SS0000C00E0000C1
11111111111111111111111111